1111111111111
1P000C0C000E1
1111111111111