1111111111111
1P0000000C0E1
1111111111111