1111111111
1P00C000E1
1011101101
1010000101
1010110101
1010100001
1010110101
1111111111
