11111111111111111111111111111
1C00000000C00000000110CCCCCC1
111111100000000000011C0000001
1CCC0000001111100001111110001
11111110000000000000000000001
10000000000000000000000000001
10000011111100000001111111111
100000000C1100000001000000001
10000000000101100000000000001
11111111000001100001000100001
10000011000001100001000100CC1
1P00E000CCCCC1100001CCC100001
11111111111111111111111111111