11111111111111111
1E0C0C0C0C0C0C0C1
1CC0C0C0C0C0C0C01
100C0C0C0C0C0C0C1
11111111111111001
10000000000000001
10000000000000001
10000000000000001
1P000000000000001
11111111111111111