11111111111111111
1ECC0C0C0C0CCCCC1
1CC0C0C0C0C0CCCC1
1CCC0C0C0C0CCCCC1
11111111111111001
10000000000000001
10000000000000001
10000000000000001
1P000000000000001
11111111111111111